10 10
##########
#__#_____#
#__#_____#
#__#_____#
#__#_T___#
#________#
#__#_____#
#__#P____#
#__#_____#
##########


