10 10
##########
#_P#__#__#
#_____#__#
####__#__#
#__#__#__#
#________#
#__#_#####
#__#P_#_##
#__#_____#
##########


