10 10
##########
#_T#_____#
#__#_____#
####_____#
#__#_T___#
#________#
#__#_____#
#__#P____#
#__#_____#
##########


