10 10
##########
#____#___#
#_#__#_#_#
#_####_#_#
#___P#__P#
#__#_____#
#_##___#_#
#__###_#_#
#__#_____#
##########


