10 10
##########
#____#___#
#_#_T#_#_#
#_####_#_#
#___P#__P#
#__#_____#
#_##___#_#
#__###_#_#
#_T#T____#
##########


